16
1
0 20
0 20
10 2 6 2 10 7 9 7
6 2 6 6 9 7 9 8
6 6 2 6 9 8 8 8
2 6 2 9 8 8 8 9
2 9 2 12 8 9 8 10
2 12 6 12 8 10 9 10
6 12 6 16 9 10 9 11
6 16 10 16 9 11 10 11
10 16 14 16 10 11 11 11
14 16 14 12 11 11 11 10
14 12 18 12 11 10 12 10
18 12 18 9 12 10 12 9
18 9 18 6 12 9 12 8
18 6 14 6 12 8 11 8
14 6 14 2 11 8 11 7
14 2 10 2 11 7 10 7