16
1
0 20
0 18
4 2 4 6 7 4 7 6
4 6 4 10 7 6 7 8
4 10 4 14 7 8 7 10
4 14 7 14 7 10 8.5 10
7 14 10 14 8.5 10 10 10
10 14 13 14 10 10 11.5 10
13 14 16 14 11.5 10 13 10
16 14 16 10 13 10 13 8
16 10 16 6 13 8 13 6
16 6 16 2 13 6 13 4
16 2 14 2 13 4 12 4
14 2 12 2 12 4 11 4
12 2 10 2 11 4 10 4
10 2 8 2 10 4 9 4
8 2 6 2 9 4 8 4
6 2 4 2 8 4 7 4